{
  "level": 2,
  "name": "Level 2",
  "startingHearts": 15,
  "startingCoins": 300,
  "numWaves": 5,
  "grid": [
    [0, 0, 0, 0, 0, 0, 0, 0, 0, 2, 2, 0, 0, 0, 0, 0, 0, 0, 0, 0],
    [0, 0, 0, 0, 0, 0, 2, 2, 2, 2, 2, 0, 0, 0, 0, 0, 0, 0, 0, 0],
    [0, 0, 0, 0, 0, 2, 2, 1, 0, 1, 2, 2, 2, 0, 0, 0, 0, 0, 0, 0],
    [0, 0, 0, 0, 2, 2, 1, 0, 0, 0, 0, 1, 2, 2, 0, 0, 0, 0, 0, 0],
    [0, 0, 0, 0, 2, 1, 0, 0, 0, 0, 0, 0, 1, 2, 0, 0, 0, 0, 0, 0],
    [0, 0, 0, 1, 2, 0, 0, 0, 0, 0, 1, 2, 2, 0, 0, 0, 0, 0, 0, 0],
    [0, 0, 0, 0, 2, 2, 1, 0, 1, 2, 2, 2, 0, 0, 0, 0, 0, 0, 0, 0],
    [0, 0, 0, 0, 0, 2, 2, 2, 2, 2, 0, 1, 0, 0, 0, 0, 0, 0, 0, 0],
    [0, 0, 0, 0, 0, 0, 2, 2, 0, 1, 0, 0, 0, 0, 0, 0, 0, 0, 0, 0],
    [0, 0, 0, 0, 0, 2, 2, 0, 0, 0, 0, 0, 0, 0, 0, 0, 0, 0, 0, 0]
  ]
}
