{
  "level": 3,
  "name": "Level 3",
  "startingHearts": 20,
  "startingCoins": 10,
  "numWaves": 7,
  "grid": [
    [0, 0, 0, 0, 2, 2, 2, 2, 2, 2, 2, 2, 2, 2, 2, 0, 0, 0, 0, 0],
    [0, 0, 0, 2, 2, 1, 0, 0, 0, 0, 0, 0, 0, 1, 2, 2, 0, 0, 0, 0],
    [0, 0, 0, 2, 0, 0, 0, 0, 0, 0, 0, 0, 0, 0, 1, 2, 0, 0, 0, 0],
    [0, 0, 0, 2, 2, 2, 2, 2, 2, 2, 0, 0, 0, 1, 2, 2, 0, 0, 0, 0],
    [0, 0, 0, 0, 1, 0, 1, 0, 1, 2, 2, 2, 0, 2, 2, 0, 0, 0, 0, 0],
    [0, 2, 2, 2, 2, 2, 2, 2, 2, 2, 0, 2, 2, 2, 0, 0, 0, 0, 0, 0],
    [0, 2, 0, 0, 0, 0, 0, 0, 1, 0, 0, 0, 0, 0, 0, 0, 0, 0, 0, 0],
    [0, 2, 0, 0, 1, 0, 1, 2, 2, 0, 1, 0, 0, 0, 0, 0, 0, 0, 0, 0],
    [0, 2, 2, 2, 2, 2, 2, 2, 2, 2, 2, 2, 2, 1, 0, 0, 0, 0, 0, 0],
    [0, 0, 0, 1, 0, 2, 0, 0, 0, 0, 0, 0, 2, 0, 0, 0, 0, 0, 0, 0]
  ]
}
