{
  "level": 2,
  "name": "Level 2",
  "startingHearts": 20,
  "startingCoins": 10,
  "numWaves": 5,
  "grid": [
    [0, 0, 0, 0, 0, 0, 0, 0, 0, 0, 2, 0, 0, 0, 0, 0, 0, 0, 0, 0],
    [0, 0, 0, 0, 0, 0, 2, 2, 2, 2, 2, 0, 0, 0, 0, 0, 0, 0, 0, 0],
    [0, 0, 0, 0, 0, 2, 2, 1, 0, 1, 2, 2, 2, 0, 0, 0, 0, 0, 0, 0],
    [0, 0, 0, 0, 2, 2, 1, 0, 0, 0, 0, 1, 2, 2, 0, 0, 0, 0, 0, 0],
    [0, 0, 0, 0, 2, 1, 0, 0, 0, 0, 0, 0, 1, 2, 0, 0, 0, 0, 0, 0],
    [0, 0, 0, 1, 2, 0, 0, 0, 0, 0, 1, 2, 2, 2, 0, 0, 0, 0, 0, 0],
    [0, 0, 0, 0, 2, 2, 1, 0, 1, 2, 2, 2, 0, 0, 0, 0, 0, 0, 0, 0],
    [0, 0, 0, 0, 0, 2, 2, 2, 2, 2, 0, 1, 0, 0, 0, 0, 0, 0, 0, 0],
    [0, 0, 0, 0, 0, 0, 2, 2, 0, 1, 0, 0, 0, 0, 0, 0, 0, 0, 0, 0],
    [0, 0, 0, 0, 0, 2, 2, 0, 0, 0, 0, 0, 0, 0, 0, 0, 0, 0, 0, 0]
  ]
}
